Gg,Gg,Gg,Gg,Gg,Gg,Gg
Gg,Gg,Gg,Gg,Gg,Gg,Gg
Gg,Gg,Gg,Gg,Gg,Gg,Gg
Gg,Gg,Gg,Rr,Gg,Gg,Gg
Gg,Gg,Gg,Gg,Gg,Gg,Gg
Gg,Gg,Gg,Gg,Gg,Gg,Gg
Gg,Gg,Gg,Gg,Gg,Gg,Gg
